################################################################################
#                                  #                                           #
#                                  #                                           #
#                                  #                                           #
#                                  #                                           #
#                                                                              #
#                                                                              #
#                                  #                                           #
#                                  #                                           #
#                                  #                                           #
#                                  #                                           #
#                                  #                                           #
##########################         #################       #####################
#                                                                              #
#                                                                              #
#                                                                              #
#                                                                              #
#                                                                              #
#                                                                              #
#                                                                              #
#                                                                              #
#                                                                              #
#                                                                              #
#                                                                              #
#                                                                              #
#                                                                              #
########              ##############################                       #####
#                                                                              #
#                                                                              #
#                                                                              #
#                                                                              #
#                                                                              #
#                                                                              #
#                                                                              #
#                                                                              #
#                                                                              #
###########################################                #####################
#                                                                              #
#                                                                              #
#                                                                              #
#                                                                              #
#                                                                              #
#                                                                              #
#                                                                              #
#                                                                              #
#                                                                              #
#                                                                              #
#                                                                              #
#                                                                              #
################################################################################