################################################################################
#                                  #                                           #
#                                  #                                           #
#                                  #                                           #
#########                ###########                                           #
#                                  #                                           #
#                                  #               ##########                  #
#                                  #                                           #
#######################            #                                           #
#                                  #                                           #
#                                  #                                           #
#                                  #                                           #
##########################         #                                           #
#                                                                              #
#                                                                              #
#                                                                              #
#                                          ####################                #
#                                                                              #
#                                                                              #
#                                                                              #
#                                                                              #
#                #########################################                     #
#                                                                              #
#                                                                              #
#                                                                              #
#                                                                              #
#                                                                              #
#                                                                              #
########              ##############################                       #####
#                                                                              #
#                                                                              #
#                                                                              #
################                                                               #
#                                                                              #
#                                                                              #
#                                                                              #
###########################################                #####################
#                                                                              #
#                                                                              #
#                                  #############################################
#                                                                              #
#                                                                              #
#                                                                              #
#                                                                              #
#                                                                              #
#           ############################################################       #
###                                                                            #
#                                                                              #
#                                                                              #
################################################################################