################################################################################
#               #      #           #                                 #         #
#                #     #           #                                 #         #
#                                  #                                 ###       #
################         ###########                                 #         #
#                                  #                                 #         #
#       #      #                   #               ##########        #     #####
#       #      #                   #                                 #         #
#       #      #                   #                                 #         #
#       #      #                   #                                 ####      #
#       #                          #                                           #
#       #                          #                                           #
#       ##################         #         #######################           #
#       #                                                                      #
#       #                                                                      #
#       #                #                                            #        #
#       #                #                  ####################      ##########
#       #                #                                            #        #
#       #                ##########                                            #
#       #                                             ########                 #
#       #                                                                      #
#       #               #############                                          #
#       #                                                             #        #
#       #         ######            ##########                        #        #
#       #                                                             #        #
#       #         #########################################           #        #
#       #                                                       #######        #
#                                                                              #
########              ##############################                       #####
#                                    #                             #           #
#                                    #                             #           #
#                                    #               #             #           #
###                                  #               #                         #
#                                                    #             #           #
#                                                    #                         #
#                                                    #                         #
###########################################          #     #####################
#         #                               #          #                         #
#         #                        #                                           #
#        #                         #############################################
#       #                                                              #       #
#                                                                      #       #
#                #########################################             #       #
#                                          #                           #       #
#                                                                              #
#       ########################################################               #
###         #                      #                                           #
#                                  #       #                        #          #
#           #                              #                        #          #
################################################################################