################################################################################
#                                  #                                 #         #
#                                  #                                 #         #
#                                  #                                 #         #
#########                ###########                                 #         #
#                                  #                                 #         #
#              #                   #               ##########        #         #
#              #                   #                                 #         #
#              #                   #                                 #         #
#              #                   #                                 #         #
#                                  #                                           #
#                                  #                                           #
##########################         #         #######################           #
#                                                                              #
#                                                                              #
#       #                #                                            #        #
#       #                #                  ####################      #        #
#       #                #                                            #        #
#       #                ##########                                   #        #
#       #                                                             #        #
#       #                                                             #        #
#       #         #########################################           #        #
#       #                                                             #        #
#       #                                                             #        #
#       #                                                             #        #
#       #         #########################################           #        #
#       #                                                       #######        #
#                                                                              #
########              ##############################                       #####
#                                                                  #           #
#                                                                  #           #
#                        #                           #             #           #
################         #                           #                         #
#                                            #######################           #
#                                                                              #
#                                                                              #
###########################################                #####################
#         #                                                                    #
#         #                                                                    #
#        #                         #############################################
#       #                                                                      #
#      #                                                                       #
#     #          #########################################                     #
#    #                                                                         #
#                                                                              #
#           ############################################################       #
###                                                                            #
#                                                                              #
#                                                                              #
################################################################################